21 21
1 default 
10 19
10 1
1 1 1 1 1 1 1 1 1 1 1 1 1 1 1 1 1 1 1 1 1 
1 1 1 1 1 1 1 1 1 1 1 1 1 1 1 1 1 1 1 1 1 
1 1 1 1 1 1 1 1 1 1 1 1 1 1 1 1 1 1 1 1 1 
1 1 1 1 1 1 1 1 1 1 1 1 1 1 1 1 1 1 1 1 1 
1 1 1 1 1 1 1 1 1 1 1 1 1 1 1 1 1 1 1 1 1 
1 1 1 1 1 1 1 1 1 1 1 1 1 1 1 1 1 1 1 1 1 
1 1 1 1 1 1 1 1 1 1 1 1 1 1 1 1 1 1 1 1 1 
1 1 1 1 1 1 1 1 1 1 1 1 1 1 1 1 1 1 1 1 1 
1 1 1 1 1 1 1 1 1 1 1 1 1 1 1 1 1 1 1 1 1 
1 1 1 1 1 1 1 1 1 1 1 1 1 1 1 1 1 1 1 1 1 
1 1 1 1 1 1 1 1 1 1 1 1 1 1 1 1 1 1 1 1 1 
1 1 1 1 1 1 1 1 1 1 1 1 1 1 1 1 1 1 1 1 1 
1 1 1 1 1 1 1 1 1 1 1 1 1 1 1 1 1 1 1 1 1 
1 1 1 1 1 1 1 1 1 1 1 1 1 1 1 1 1 1 1 1 1 
1 1 1 1 1 1 1 1 1 1 1 1 1 1 1 1 1 1 1 1 1 
1 1 1 1 1 1 1 1 1 1 1 1 1 1 1 1 1 1 1 1 1 
1 1 1 1 1 1 1 1 1 1 1 1 1 1 1 1 1 1 1 1 1 
1 1 1 1 1 1 1 1 1 1 1 1 1 1 1 1 1 1 1 1 1 
1 1 1 1 1 1 1 1 1 1 1 1 1 1 1 1 1 1 1 1 1 
1 1 1 1 1 1 1 1 1 1 1 1 1 1 1 1 1 1 1 1 1 
1 1 1 1 1 1 1 1 1 1 1 1 1 1 1 1 1 1 1 1 1 

2 2 2 2 2 2 2 2 2 2 2 2 2 2 2 2 2 2 2 2 2 
2 0 0 0 0 3 3 3 3 3 0 3 3 3 3 3 0 0 0 0 2 
2 0 3 3 0 3 3 3 3 3 3 3 3 3 3 3 0 3 3 0 2 
2 0 3 3 0 3 3 3 3 3 3 3 3 3 3 3 0 3 3 0 2 
2 0 0 0 0 3 3 0 0 3 2 3 0 0 3 3 0 0 0 0 2 
2 0 0 2 0 3 3 0 0 0 0 0 0 0 3 3 0 2 0 0 2 
2 2 2 2 0 0 0 0 0 0 0 0 0 0 0 0 0 2 2 2 2 
2 0 0 0 0 0 2 0 0 0 0 0 2 2 2 0 0 0 0 0 2 
2 0 0 0 0 0 0 0 0 0 0 0 0 0 0 0 0 0 0 0 2 
2 0 0 5 5 5 5 5 5 5 5 5 5 5 5 5 5 5 0 0 2 
2 0 0 5 5 5 5 5 5 5 5 5 5 5 5 5 5 5 0 0 2 
2 0 0 5 5 5 5 5 5 5 5 5 5 5 5 5 5 5 0 0 2 
2 0 0 0 0 0 0 0 0 0 0 0 0 0 0 0 0 0 0 0 2 
2 0 0 0 0 0 0 0 0 0 0 0 0 0 0 0 0 0 0 0 2 
2 2 2 2 0 0 0 0 0 0 0 0 0 0 0 0 0 2 2 2 2 
2 0 0 2 0 3 3 0 0 0 0 0 0 0 3 3 0 2 0 0 2 
2 0 0 0 0 3 3 0 0 3 2 3 0 0 3 3 0 0 0 0 2 
2 0 3 3 0 3 3 3 3 3 3 3 3 3 3 3 0 3 3 0 2 
2 0 3 3 0 3 3 3 3 3 3 3 3 3 3 3 0 3 3 0 2 
2 0 0 0 0 3 3 3 3 3 0 3 3 3 3 3 0 0 0 0 2 
2 2 2 2 2 2 2 2 2 2 2 2 2 2 2 2 2 2 2 2 2 

0 0 0 0 0 0 0 0 0 0 0 0 0 0 0 0 0 0 0 0 0 
0 0 0 0 0 0 0 0 0 0 0 0 0 0 0 0 0 0 0 0 0 
0 0 0 0 0 0 0 0 0 0 0 0 0 0 0 0 0 0 0 0 0 
0 0 0 0 0 0 0 0 0 0 0 0 0 0 0 0 0 0 0 0 0 
0 0 0 0 0 0 0 0 0 0 0 0 0 0 0 0 0 0 0 0 0 
0 0 0 0 0 0 0 0 0 0 0 0 0 0 0 0 0 0 0 0 0 
0 0 0 0 0 0 0 0 0 0 0 0 0 0 0 0 0 0 0 0 0 
0 0 0 0 0 0 0 0 0 0 0 0 0 0 0 0 0 0 0 0 0 
0 4 4 0 0 0 0 0 0 0 0 0 0 0 0 0 0 0 4 4 0 
0 4 4 0 0 0 0 0 0 0 0 0 0 0 0 0 0 0 4 4 0 
0 4 4 0 0 0 0 0 0 0 0 0 0 0 0 0 0 0 4 4 0 
0 4 4 0 0 0 0 0 0 0 0 0 0 0 0 0 0 0 4 4 0 
0 4 4 0 0 0 0 0 0 0 0 0 0 0 0 0 0 0 4 4 0 
0 0 0 0 0 0 0 0 0 0 0 0 0 0 0 0 0 0 0 0 0 
0 0 0 0 0 0 0 0 0 0 0 0 0 0 0 0 0 0 0 0 0 
0 0 0 0 0 0 0 0 0 0 0 0 0 0 0 0 0 0 0 0 0 
0 0 0 0 0 0 0 0 0 0 0 0 0 0 0 0 0 0 0 0 0 
0 0 0 0 0 0 0 0 0 0 0 0 0 0 0 0 0 0 0 0 0 
0 0 0 0 0 0 0 0 0 0 0 0 0 0 0 0 0 0 0 0 0 
0 0 0 0 0 0 0 0 0 0 0 0 0 0 0 0 0 0 0 0 0 
0 0 0 0 0 0 0 0 0 0 0 0 0 0 0 0 0 0 0 0 1 

8 16
8 16
11 16
12 16
7 4
8 4
11 4
12 4
0 6 7 0 2 